11111111111111111111
10000000000000000001
10000000000000000001
10000000000000000001
10000000000000011111
10000000000000000001
10000000000000000001
10001111111110000001
10000000000000000001
10000000000000000001
10000000011010100001
10000000000000000001
10000000000000000001
10000010111010000001
10000000000000000001
10000000000000000E01
10000000000000000001
10000E000000000E0001
10000000000000000001
11111111111111110111